Treba napraviti:

Konsistentne podatke priko svega - trenutno se minjaju seme za podatke u /venue ili u /cart i na drugim mistima - Brkic

Definirat tocno ka scheme za database za venue service i dodati to u database i vuci podatke iz databasea i displayat - Luka

API i dohvati podataka: Implementacija API endpointova (ili Next.js server akcija) za dohvat podataka iz baze (npr. popisi prostora/usluga, detalji, pretraga, filtriranje). - Luka

Evidencija booking-a: Postavljanje modela za booking (rezervacije) kako bi se uspješne narudžbe spremile u bazu (za potrebe dashboarda korisnika i sl.). - Luka

Slike i fileovi - treba dodat storage za to, cloudinary moja preporuka al ak se nade jos nes bolje recite. - Marin

Booking system i cart context - pobosljati ako se more viditi kako trenutno sve stoji - Luka

UI popraviti - di god se nadu greske to risavati - Svi

Venue policy nema padding

Venue amenities styling

Venue detail pages full width

Blokirati stvari ako nisi sign inan - tipa booking - Marin

Popravit typescript errore - SVI

Optimizirat kod - splittat sve hookove napravit typeove performance poboljsat etc etc sve znas kume - SVI





NOVO

Figma - pretvoriti cilu str u design i napraviti prototype koji more cili flow odraditi. (design.txt)

Autorizacija - protectati sve API rute, middleware

Venue Details Page - kada se stisne book now triba vodit na cart - rijeseno
Footer - fixat gatherly - rijeseno

Static site generation - stavit na static pageve, SSR isto

Connect to MongoDB - fixat da se samo jednom connecta

Booking thank you - lokacija se pokazuje samo "/", cart se ne emptya

Mapa - dodati da se moze otvorit u novom tabu google maps

External Venue - sjebano radi, triba fixat ili mozda maknut

Hydration error - fixat

Error handling - dodat loganje, Sentry koristit. Monitoring svega, /api/health ruta za provjeru da li servisi rade

Build errori - build treba raditi bez ikakvih erorra il warninga

npm errori - npm triba moc installat bez forcea ili iceg

Security - Stripe, podatci iz baze, booking itd

Metadata - dodat metadata na pageve

Optimizirat kod - u svakom pogledu, imat 4 sloja, componenta, hook,service,api

Testing - unit a i dok se builda i to, ako failaju testovi nemoze se buildat ni deployat

CI/CD

POPRAVITI Footer

